1)

30 68 60 38 52 57 27  
59 38 30 26 11 54 66  
68 34 58 16 20 58 24  
29 54 53 46 30 48 65  
64 10 12 22 45 51 43  
25 31 48 11 20 37 34  
53 64 55 68 51 36 55

2)

53 28 55 34 45 56 63  
23 40 22 63 21 63 50  
53 40 21 20 24 21 37  
41 21 46 47 20 51 57  
55 65 35 37 30 24 51  
49 62 66 54 64 68 25  
21 25 28 44 65 56 65 

3)

30 38 21 29 39 28 48  
53 24 25 47 48 47 52  
35 47 25 27 33 44 48  
47 44 43 38 50 34 43  
53 34 49 28 11 42 26  
40 26 32 48 15 49 32  
30 26 51 26 18 17 29

4)

32 35 22 48 43 45 34  
35 42 25 44 54 29 50  
46 22 25 36 54 41 51  
43 10 20 32 49 51 49  
47 11 20 45 38 25 32  
41 10 36 41 49 30 23  
14 8 51 47 32 26 44 

5)

29 50 44 38 32 30 27  
29 33 50 35 35 44 43  
20 37 37 47 44 35 43  
35 33 29 17 24 31 54  
52 14 20 22 46 43 46  
54 45 41 35 42 32 51  
43 22 47 24 38 33 49 

6)

40 29 27 15 59 20 27 
15 29 27 14 21 36 53  
44 27 21 22 30 39 30  
28 32 42 37 38 38 16  
27 35 41 31 41 17 34  
21 28 43 44 39 39 16  
25 38 29 32 19 42 36  

7)

39 20 36 32 23 33 29  
23 20 30 15 36 37 27  
35 37 15 28 38 38 19  
27 18 38 23 15 18 33  
28 27 16 28 25 7 17  
28 28 19 22 35 15 54  
34 37 29 16 22 0 60  

8)

38 40 28 32 32 29 43  
59 49 52 42 29 35 37  
39 30 14 43 61 9 56  
58 50 19 6 17 27 76  
60 25 44 35 25 47 63  
21 50 61 24 62 59 43  
34 61 41 46 27 26 49 

9)

36 47 21 49 26 26 29  
25 47 29 16 26 40 34  
44 20 59 12 49 30 24  
37 15 18 41 58 25 24  
45 37 23 23 19 11 67  
25 17 37 44 23 31 57  
18 27 15 43 55 39 23

10)

33 41 25 43 44 33 38  
33 37 32 30 30 28 41  
24 30 32 35 25 21 36  
20 21 41 22 42 18 22  
43 23 21 22 13 21 23  
36 23 23 24 20 34 42  
24 20 43 44 24 20 35

11)

43 26 34 22 42 30 30  
25 19 16 34 52 53 38  
27 17 47 26 19 44 35  
39 15 26 53 37 38 35  
44 21 31 27 36 48 28  
16 7 52 44 38 37 25  
22 32 16 52 19 41 37  

12)

17 31 36 28 28 20 22  
18 38 41 14 12 35 12  
15 26 44 38 41 30 20  
42 28 28 44 41 22 17  
41 29 22 41 16 25 32  
12 25 12 12 21 15 54  
45 20 35 15 12 14 50

13)

27 38 38 43 18 38 38  
41 29 31 44 37 21 29  
20 35 6 5 48 57 54  
41 24 21 13 42 34 54  
18 30 28 19 16 49 40  
38 44 29 25 13 14 57 
38 29 39 16 41 29 44 

14)

53 31 19 32 32 29 48  
18 2 51 45 29 33 34  
47 46 42 8 15 47 32  
36 39 33 45 46 23 33  
40 47 28 27 50 47 24  
33 31 38 16 31 33 34  
25 38 21 19 31 44 33 

15)

52 29 27 50 38 12 31  
44 36 31 23 26 33 24  
41 48 31 43 18 34 27  
20 47 48 18 30 39 28  
48 18 22 32 29 46 36  
47 29 29 45 19 23 20  
27 50 25 36 26 48 17 

16)

32 59 27 28 60 23 59  
57 22 57 30 39 20 22  
65 28 61 29 43 58 27  
54 42 53 38 42 35 34  
38 16 23 25 60 16 38  
64 35 51 24 32 57 53  
57 40 27 62 49 49 51

17)

20 46 29 41 44 34 36  
35 40 26 56 17 22 5  
38 21 25 52 15 46 46  
47 47 19 15 21 25 45  
44 43 32 24 33 31 49  
48 24 27 15 47 32 30  
20 44 24 21 45 37 19  

18)

20 37 18 41 40 36 35  
18 21 45 47 27 38 29  
52 50 17 40 19 17 20  
48 34 40 29 18 16 19  
15 54 38 45 19 34 39  
26 45 17 47 33 17 42  
18 53 52 25 48 16 25 

19)

41 27 12 19 28 37 24  
46 43 7 17 41 9 10  
52 35 14 15 18 5 20  
23 24 39 42 24 17 36  
15 29 32 35 28 41 32  
26 23 23 39 42 40 38  
33 23 24 19 39 33 44  

21)

38 4 4 4 51 53 41  
33 12 38 16 42 44 47  
45 4 46 25 19 33 52  
33 1 38 19 61 29 27  
30 10 36 15 43 12 49  
30 8 33 19 57 16 55  
37 9 49 35 20 19 62  

22)

30 35 29 26 34 29 43  
34 38 44 36 10 40 30  
44 30 11 24 11 25 14  
36 17 15 17 21 10 43  
38 27 12 22 18 39 16  
11 41 13 40 40 41 31  
38 33 14 32 25 41 39 

23)

42 29 39 24 20 29 47  
49 37 56 60 41 45 25  
52 51 6 19 42 43 46  
52 57 34 11 13 25 39  
39 60 18 11 32 54 60  
45 16 37 8 27 33 49  
60 47 15 58 29 29 41 

24)

41 39 21 16 21 23 55  
45 39 21 51 34 48 49  
30 36 12 25 21 49 37  
24 21 20 44 46 32 51  
15 26 19 27 38 37 58  
60 42 60 8 51 16 58  
49 38 46 30 52 53 15  

25)

63 51 18 36 53 54 62  
18 62 44 53 15 56 29  
5 24 21 55 34 33 61  
40 55 15 32 17 49 49  
56 36 26 33 23 43 44  
60 45 15 63 38 39 37  
48 46 31 15 15 63 58  

26)

44 52 23 24 45 43 32  
35 22 37 39 24 23 30  
37 50 39 30 53 48 28  
32 19 17 17 39 13 22  
9 19 44 17 13 12 49  
36 41 49 19 39 21 50  
49 30 15 52 40 17 29 

27)

40 23 48 13 60 45 57  
47 14 36 62 40 16 51  
17 30 40 27 59 26 27  
37 27 16 18 57 23 34  
15 41 33 28 40 34 17  
48 58 22 25 33 27 12  
43 25 14 63 46 27 14  

28)

54 11 25 25 28 13 39  
55 18 54 39 27 4 66  
22 49 15 17 41 53 53  
42 39 2 53 10 31 29  
10 23 42 14 39 37 33  
42 60 43 40 60 36 41  
52 55 19 55 46 47 32

29)

10 38 23 42 36 18 15  
31 12 40 31 34 15 31  
44 17 23 32 32 1 29  
12 29 41 34 33 4 21  
18 14 38 31 37 2 49  
41 20 18 30 31 6 44  
39 22 27 12 33 13 29

30)

63 17 13 16 33 48 25  
26 50 17 18 63 50 31  
41 53 45 33 19 42 23  
38 26 60 23 28 38 22  
42 29 33 43 39 28 35  
33 21 35 34 37 43 56  
59 35 33 32 23 38 52

31)
18 37 39 66 26 27 43  
38 41 44 58 41 45 20  
29 29 37 8 20 24 57  
36 5 57 44 11 9 52  
26 34 50 26 47 28 26  
7 7 21 35 43 39 43  
36 25 42 30 24 39 47  

32)

17 51 42 36 24 24 52  
38 15 29 29 16 35 48  
16 46 4 4 49 35 55  
53 52 37 6 28 45 69  
25 52 35 14 17 47 64  
53 58 27 52 15 21 58  
32 38 48 49 37 17 29 

33)

30 29 38 17 33 21 15  
40 15 44 41 22 26 30  
26 29 28 20 34 15 33  
33 20 15 21 34 15 18  
40 43 22 34 45 16 26  
32 44 34 31 32 10 60  
19 41 16 16 1 3 74  

34)

41 27 37 45 53 22 28  
17 24 35 15 50 26 57  
52 11 27 34 17 47 54  
38 43 53 31 51 45 21  
17 47 47 39 23 32 63  
57 23 31 27 57 66 65  
65 24 56 53 27 34 55  

35)

25 34 28 34 38 42 47  
36 25 35 49 22 31 24  
40 48 23 41 21 39 45  
28 23 34 31 46 40 33  
35 33 22 39 25 32 39  
39 34 36 47 31 22 48  
32 22 22 20 35 36 28 

36)

42 24 28 27 35 35 48  
33 21 31 16 63 29 38  
16 32 51 20 62 44 23  
12 14 63 53 46 45 47  
48 19 19 18 45 45 46  
63 15 26 35 16 63 66  
44 48 52 42 36 17 29 

37)

38 28 25 20 25 34 33  
16 36 20 34 35 27 30  
25 16 28 39 36 23 21  
53 12 14 11 67 20 32  
38 38 57 7 38 21 38  
20 59 45 23 17 12 14  
19 16 37 27 25 16 38 

38)

30 38 32 15 25 21 37  
33 34 34 19 24 21 25  
15 20 30 36 25 19 16  
22 36 25 2 17 14 51  
33 18 22 25 35 26 28  
25 22 25 30 24 27 32  
36 31 19 24 24 32 30  

39)

34 50 42 49 62 41 54  
2 5 54 31 35 59 44  
44 2 38 25 31 60 59  
40 5 53 32 13 38 61  
53 19 49 52 18 62 40  
50 26 22 28 38 33 29  
45 58 18 36 36 45 40 

40)

15 50 25 32 34 46 39  
43 45 53 27 15 10 63  
31 20 19 49 54 58 58  
32 13 18 36 42 39 45  
44 45 14 49 38 39 63  
49 45 35 36 35 45 53  
51 62 17 41 26 62 31